8988T	encode/wgEncodeAwgDnaseDuke8988tUniPk.narrowPeak.gz
AoSMC	encode/wgEncodeAwgDnaseDukeAosmcUniPk.narrowPeak.gz
Chorion	encode/wgEncodeAwgDnaseDukeChorionUniPk.narrowPeak.gz
CLL	encode/wgEncodeAwgDnaseDukeCllUniPk.narrowPeak.gz
Fibrobl	encode/wgEncodeAwgDnaseDukeFibroblUniPk.narrowPeak.gz
FibroP	encode/wgEncodeAwgDnaseDukeFibropUniPk.narrowPeak.gz
Gliobla	encode/wgEncodeAwgDnaseDukeGlioblaUniPk.narrowPeak.gz
GM12891	encode/wgEncodeAwgDnaseDukeGm12891UniPk.narrowPeak.gz
GM12892	encode/wgEncodeAwgDnaseDukeGm12892UniPk.narrowPeak.gz
GM18507	encode/wgEncodeAwgDnaseDukeGm18507UniPk.narrowPeak.gz
GM19238	encode/wgEncodeAwgDnaseDukeGm19238UniPk.narrowPeak.gz
GM19239	encode/wgEncodeAwgDnaseDukeGm19239UniPk.narrowPeak.gz
GM19240	encode/wgEncodeAwgDnaseDukeGm19240UniPk.narrowPeak.gz
H9ES	encode/wgEncodeAwgDnaseDukeH9esUniPk.narrowPeak.gz
HeLa-S3_IFNa4h	encode/wgEncodeAwgDnaseDukeHelas3ifna4hUniPk.narrowPeak.gz
Hepatocytes	encode/wgEncodeAwgDnaseDukeHepatocytesUniPk.narrowPeak.gz
HPDE6-E6E7	encode/wgEncodeAwgDnaseDukeHpde6e6e7UniPk.narrowPeak.gz
HSMM_emb	encode/wgEncodeAwgDnaseDukeHsmmembUniPk.narrowPeak.gz
HTR8svn	encode/wgEncodeAwgDnaseDukeHtr8svnUniPk.narrowPeak.gz
Huh-7.5	encode/wgEncodeAwgDnaseDukeHuh75UniPk.narrowPeak.gz
Huh-7	encode/wgEncodeAwgDnaseDukeHuh7UniPk.narrowPeak.gz
iPS	encode/wgEncodeAwgDnaseDukeIpsUniPk.narrowPeak.gz
Ishikawa_Estradiol	encode/wgEncodeAwgDnaseDukeIshikawaestradiolUniPk.narrowPeak.gz
Ishikawa_4OHTAM	encode/wgEncodeAwgDnaseDukeIshikawatamoxifenUniPk.narrowPeak.gz
LNCaP_androgen	encode/wgEncodeAwgDnaseDukeLncapandrogenUniPk.narrowPeak.gz
MCF-7_Hypoxia	encode/wgEncodeAwgDnaseDukeMcf7hypoxiaUniPk.narrowPeak.gz
Medullo	encode/wgEncodeAwgDnaseDukeMedulloUniPk.narrowPeak.gz
Melano	encode/wgEncodeAwgDnaseDukeMelanoUniPk.narrowPeak.gz
Myometr	encode/wgEncodeAwgDnaseDukeMyometrUniPk.narrowPeak.gz
Osteobl	encode/wgEncodeAwgDnaseDukeOsteoblUniPk.narrowPeak.gz
PanIsletD	encode/wgEncodeAwgDnaseDukePanisletdUniPk.narrowPeak.gz
PanIslets	encode/wgEncodeAwgDnaseDukePanisletsUniPk.narrowPeak.gz
pHTE	encode/wgEncodeAwgDnaseDukePhteUniPk.narrowPeak.gz
ProgFib	encode/wgEncodeAwgDnaseDukeProgfibUniPk.narrowPeak.gz
RWPE1	encode/wgEncodeAwgDnaseDukeRwpe1UniPk.narrowPeak.gz
Stellate	encode/wgEncodeAwgDnaseDukeStellateUniPk.narrowPeak.gz
T-47D	encode/wgEncodeAwgDnaseDukeT47dUniPk.narrowPeak.gz
CD4_Th0	encode/wgEncodeAwgDnaseDukeTh0UniPk.narrowPeak.gz
Urothelia	encode/wgEncodeAwgDnaseDukeUrotheliaUniPk.narrowPeak.gz
Urothelia_UT189	encode/wgEncodeAwgDnaseDukeUrotheliaut189UniPk.narrowPeak.gz
AG04449	encode/wgEncodeAwgDnaseUwAg04449UniPk.narrowPeak.gz
AG04450	encode/wgEncodeAwgDnaseUwAg04450UniPk.narrowPeak.gz
AG09309	encode/wgEncodeAwgDnaseUwAg09309UniPk.narrowPeak.gz
AG09319	encode/wgEncodeAwgDnaseUwAg09319UniPk.narrowPeak.gz
AG10803	encode/wgEncodeAwgDnaseUwAg10803UniPk.narrowPeak.gz
AoAF	encode/wgEncodeAwgDnaseUwAoafUniPk.narrowPeak.gz
BE2_C	encode/wgEncodeAwgDnaseUwBe2cUniPk.narrowPeak.gz
BJ	encode/wgEncodeAwgDnaseUwBjUniPk.narrowPeak.gz
Caco-2	encode/wgEncodeAwgDnaseUwCaco2UniPk.narrowPeak.gz
CD20+	encode/wgEncodeAwgDnaseUwCd20UniPk.narrowPeak.gz
CD34+	encode/wgEncodeAwgDnaseUwCd34mobilizedUniPk.narrowPeak.gz
CMK	encode/wgEncodeAwgDnaseUwCmkUniPk.narrowPeak.gz
GM06990	encode/wgEncodeAwgDnaseUwGm06990UniPk.narrowPeak.gz
GM12864	encode/wgEncodeAwgDnaseUwGm12864UniPk.narrowPeak.gz
GM12865	encode/wgEncodeAwgDnaseUwGm12865UniPk.narrowPeak.gz
H7-hESC	encode/wgEncodeAwgDnaseUwH7hescUniPk.narrowPeak.gz
HAc	encode/wgEncodeAwgDnaseUwHacUniPk.narrowPeak.gz
HAEpiC	encode/wgEncodeAwgDnaseUwHaepicUniPk.narrowPeak.gz
HA-h	encode/wgEncodeAwgDnaseUwHahUniPk.narrowPeak.gz
HA-sp	encode/wgEncodeAwgDnaseUwHaspUniPk.narrowPeak.gz
HBMEC	encode/wgEncodeAwgDnaseUwHbmecUniPk.narrowPeak.gz
HCF	encode/wgEncodeAwgDnaseUwHcfUniPk.narrowPeak.gz
HCFaa	encode/wgEncodeAwgDnaseUwHcfaaUniPk.narrowPeak.gz
HCM	encode/wgEncodeAwgDnaseUwHcmUniPk.narrowPeak.gz
HConF	encode/wgEncodeAwgDnaseUwHconfUniPk.narrowPeak.gz
HCPEpiC	encode/wgEncodeAwgDnaseUwHcpepicUniPk.narrowPeak.gz
HCT-116	encode/wgEncodeAwgDnaseUwHct116UniPk.narrowPeak.gz
HEEpiC	encode/wgEncodeAwgDnaseUwHeepicUniPk.narrowPeak.gz
HFF	encode/wgEncodeAwgDnaseUwHffUniPk.narrowPeak.gz
HFF-Myc	encode/wgEncodeAwgDnaseUwHffmycUniPk.narrowPeak.gz
HGF	encode/wgEncodeAwgDnaseUwHgfUniPk.narrowPeak.gz
HIPEpiC	encode/wgEncodeAwgDnaseUwHipepicUniPk.narrowPeak.gz
HL-60	encode/wgEncodeAwgDnaseUwHl60UniPk.narrowPeak.gz
HMF	encode/wgEncodeAwgDnaseUwHmfUniPk.narrowPeak.gz
HMVEC-dAd	encode/wgEncodeAwgDnaseUwHmvecdadUniPk.narrowPeak.gz
HMVEC-dBl-Ad	encode/wgEncodeAwgDnaseUwHmvecdbladUniPk.narrowPeak.gz
HMVEC-dBl-Neo	encode/wgEncodeAwgDnaseUwHmvecdblneoUniPk.narrowPeak.gz
HMVEC-dLy-Ad	encode/wgEncodeAwgDnaseUwHmvecdlyadUniPk.narrowPeak.gz
HMVEC-dLy-Neo	encode/wgEncodeAwgDnaseUwHmvecdlyneoUniPk.narrowPeak.gz
HMVEC-dNeo	encode/wgEncodeAwgDnaseUwHmvecdneoUniPk.narrowPeak.gz
HMVEC-LBl	encode/wgEncodeAwgDnaseUwHmveclblUniPk.narrowPeak.gz
HMVEC-LLy	encode/wgEncodeAwgDnaseUwHmvecllyUniPk.narrowPeak.gz
HNPCEpiC	encode/wgEncodeAwgDnaseUwHnpcepicUniPk.narrowPeak.gz
HPAEC	encode/wgEncodeAwgDnaseUwHpaecUniPk.narrowPeak.gz
HPAF	encode/wgEncodeAwgDnaseUwHpafUniPk.narrowPeak.gz
HPdLF	encode/wgEncodeAwgDnaseUwHpdlfUniPk.narrowPeak.gz
HPF	encode/wgEncodeAwgDnaseUwHpfUniPk.narrowPeak.gz
HRCEpiC	encode/wgEncodeAwgDnaseUwHrcepicUniPk.narrowPeak.gz
HRE	encode/wgEncodeAwgDnaseUwHreUniPk.narrowPeak.gz
HRGEC	encode/wgEncodeAwgDnaseUwHrgecUniPk.narrowPeak.gz
HRPEpiC	encode/wgEncodeAwgDnaseUwHrpepicUniPk.narrowPeak.gz
HVMF	encode/wgEncodeAwgDnaseUwHvmfUniPk.narrowPeak.gz
Jurkat	encode/wgEncodeAwgDnaseUwJurkatUniPk.narrowPeak.gz
Monocytes-CD14+	encode/wgEncodeAwgDnaseUwMonocytescd14ro01746UniPk.narrowPeak.gz
NB4	encode/wgEncodeAwgDnaseUwNb4UniPk.narrowPeak.gz
NH-A	encode/wgEncodeAwgDnaseUwNhaUniPk.narrowPeak.gz
NHDF-Ad	encode/wgEncodeAwgDnaseUwNhdfadUniPk.narrowPeak.gz
NHDF-neo	encode/wgEncodeAwgDnaseUwNhdfneoUniPk.narrowPeak.gz
NHLF	encode/wgEncodeAwgDnaseUwNhlfUniPk.narrowPeak.gz
NT2-D1	encode/wgEncodeAwgDnaseUwNt2d1UniPk.narrowPeak.gz
PANC-1	encode/wgEncodeAwgDnaseUwPanc1UniPk.narrowPeak.gz
PrEC	encode/wgEncodeAwgDnaseUwPrecUniPk.narrowPeak.gz
RPTEC	encode/wgEncodeAwgDnaseUwRptecUniPk.narrowPeak.gz
SAEC	encode/wgEncodeAwgDnaseUwSaecUniPk.narrowPeak.gz
SKMC	encode/wgEncodeAwgDnaseUwSkmcUniPk.narrowPeak.gz
SK-N-MC	encode/wgEncodeAwgDnaseUwSknmcUniPk.narrowPeak.gz
SK-N-SH_RA	encode/wgEncodeAwgDnaseUwSknshraUniPk.narrowPeak.gz
Th2	encode/wgEncodeAwgDnaseUwTh2UniPk.narrowPeak.gz
WERI-Rb-1	encode/wgEncodeAwgDnaseUwWerirb1UniPk.narrowPeak.gz
WI-38	encode/wgEncodeAwgDnaseUwWi38UniPk.narrowPeak.gz
WI-38_4OHTAM	encode/wgEncodeAwgDnaseUwWi38tamoxifentamoxifenUniPk.narrowPeak.gz
A549	encode/wgEncodeAwgDnaseUwdukeA549UniPk.narrowPeak.gz
GM12878	encode/wgEncodeAwgDnaseUwdukeGm12878UniPk.narrowPeak.gz
H1-hESC	encode/wgEncodeAwgDnaseUwdukeH1hescUniPk.narrowPeak.gz
HeLa-S3	encode/wgEncodeAwgDnaseUwdukeHelas3UniPk.narrowPeak.gz
HepG2	encode/wgEncodeAwgDnaseUwdukeHepg2UniPk.narrowPeak.gz
HMEC	encode/wgEncodeAwgDnaseUwdukeHmecUniPk.narrowPeak.gz
HSMM	encode/wgEncodeAwgDnaseUwdukeHsmmUniPk.narrowPeak.gz
HSMMtube	encode/wgEncodeAwgDnaseUwdukeHsmmtubeUniPk.narrowPeak.gz
HUVEC	encode/wgEncodeAwgDnaseUwdukeHuvecUniPk.narrowPeak.gz
K562	encode/wgEncodeAwgDnaseUwdukeK562UniPk.narrowPeak.gz
LNCaP	encode/wgEncodeAwgDnaseUwdukeLncapUniPk.narrowPeak.gz
MCF-7	encode/wgEncodeAwgDnaseUwdukeMcf7UniPk.narrowPeak.gz
NHEK	encode/wgEncodeAwgDnaseUwdukeNhekUniPk.narrowPeak.gz
Th1	encode/wgEncodeAwgDnaseUwdukeTh1UniPk.narrowPeak.gz
LNG.IMR90 	roadmap/E017-DNase.hotspot.fdr0.01.peaks.bed.gz
ESC.H9 	roadmap/E008-DNase.hotspot.fdr0.01.peaks.bed.gz
ESC.H1 	roadmap/E003-DNase.hotspot.fdr0.01.peaks.bed.gz
IPSC.DF.6.9 	roadmap/E021-DNase.hotspot.fdr0.01.peaks.bed.gz
IPSC.DF.19.11 	roadmap/E022-DNase.hotspot.fdr0.01.peaks.bed.gz
ESDR.H1.NEUR.PROG 	roadmap/E007-DNase.hotspot.fdr0.01.peaks.bed.gz
ESDR.H1.BMP4.MESO 	roadmap/E004-DNase.hotspot.fdr0.01.peaks.bed.gz
ESDR.H1.BMP4.TROP 	roadmap/E005-DNase.hotspot.fdr0.01.peaks.bed.gz
ESDR.H1.MSC 	roadmap/E006-DNase.hotspot.fdr0.01.peaks.bed.gz
BLD.CD3.PPC 	roadmap/E034-DNase.hotspot.fdr0.01.peaks.bed.gz
BLD.CD3.CPC 	roadmap/E033-DNase.hotspot.fdr0.01.peaks.bed.gz
BLD.CD14.PC 	roadmap/E029-DNase.hotspot.fdr0.01.peaks.bed.gz
BLD.MOB.CD34.PC.M 	roadmap/E051-DNase.hotspot.fdr0.01.peaks.bed.gz
BLD.MOB.CD34.PC.F 	roadmap/E050-DNase.hotspot.fdr0.01.peaks.bed.gz
BLD.CD19.PPC 	roadmap/E032-DNase.hotspot.fdr0.01.peaks.bed.gz
BLD.CD56.PC 	roadmap/E046-DNase.hotspot.fdr0.01.peaks.bed.gz
SKIN.PEN.FRSK.FIB.01 	roadmap/E055-DNase.hotspot.fdr0.01.peaks.bed.gz
SKIN.PEN.FRSK.FIB.02 	roadmap/E056-DNase.hotspot.fdr0.01.peaks.bed.gz
SKIN.PEN.FRSK.MEL.01 	roadmap/E059-DNase.hotspot.fdr0.01.peaks.bed.gz
SKIN.PEN.FRSK.KER.02 	roadmap/E057-DNase.hotspot.fdr0.01.peaks.bed.gz
BRST.HMEC.35 	roadmap/E028-DNase.hotspot.fdr0.01.peaks.bed.gz
THYM.FET 	roadmap/E093-DNase.hotspot.fdr0.01.peaks.bed.gz
BRN.FET.F 	roadmap/E082-DNase.hotspot.fdr0.01.peaks.bed.gz
BRN.FET.M 	roadmap/E081-DNase.hotspot.fdr0.01.peaks.bed.gz
MUS.PSOAS 	roadmap/E100-DNase.hotspot.fdr0.01.peaks.bed.gz
MUS.TRNK.FET 	roadmap/E089-DNase.hotspot.fdr0.01.peaks.bed.gz
MUS.LEG.FET 	roadmap/E090-DNase.hotspot.fdr0.01.peaks.bed.gz
HRT.FET 	roadmap/E083-DNase.hotspot.fdr0.01.peaks.bed.gz
GI.STMC.FET 	roadmap/E092-DNase.hotspot.fdr0.01.peaks.bed.gz
GI.S.INT.FET 	roadmap/E085-DNase.hotspot.fdr0.01.peaks.bed.gz
GI.L.INT.FET 	roadmap/E084-DNase.hotspot.fdr0.01.peaks.bed.gz
GI.S.INT 	roadmap/E109-DNase.hotspot.fdr0.01.peaks.bed.gz
GI.STMC.GAST 	roadmap/E094-DNase.hotspot.fdr0.01.peaks.bed.gz
KID.FET 	roadmap/E086-DNase.hotspot.fdr0.01.peaks.bed.gz
LNG.FET 	roadmap/E088-DNase.hotspot.fdr0.01.peaks.bed.gz
OVRY 	roadmap/E097-DNase.hotspot.fdr0.01.peaks.bed.gz
ADRL.GLND.FET 	roadmap/E080-DNase.hotspot.fdr0.01.peaks.bed.gz
PLCNT.FET 	roadmap/E091-DNase.hotspot.fdr0.01.peaks.bed.gz
PANC 	roadmap/E098-DNase.hotspot.fdr0.01.peaks.bed.gz
